NO ./textures/north.xpm
SO ./textures/south.xpm
WE ./textures/west.xpm
EA ./textures/east.xpm

F 19,109,21
C 135,206,235

011111111111
100000000001
1N0000000001
100000000001
111111111111