NO ./textures/wood.xpm
SO ./textures/brick.xpm
WE ./textures/grey.xpm
EA ./textures/blue.xpm

F 220,100,0
C 225,30,0

111111111111
100000000011
101100000111
100100000001
111100011011
10000W000011
111100011111
111101111111
110000001101
100000000001
100000000001
111111111111